0 0 0 0 0 0 0 0 0 0 0 0 0 0 0 0 0 0 0 0 0 0 0 0 0 0
0 0 0 0 0 0 0 0 1 1 0 0 0 0 0 0 0 0 0 0 1 1 0 0 0 0
0 0 1 1 0 0 1 1 1 1 0 0 0 0 6 6 6 6 6 6 1 1 1 1 0 0
0 0 1 1 0 0 1 1 1 1 0 0 0 0 6 6 6 6 6 6 1 1 1 1 0 0
0 0 1 1 0 0 0 0 1 1 0 0 2 2 6 6 6 6 6 6 6 6 6 6 0 0
0 0 1 1 0 0 0 0 1 1 0 0 2 2 6 6 6 6 6 6 6 6 6 6 0 0
6 6 6 6 6 6 2 0 1 1 0 0 0 0 1 1 6 6 6 6 6 6 6 6 0 0
6 6 6 6 6 6 2 0 1 1 0 0 0 0 1 1 6 6 6 6 6 6 6 6 0 0
6 6 6 6 6 6 6 6 6 6 6 6 1 1 1 1 0 1 1 0 0 0 0 0 0 0
6 6 6 6 6 6 6 6 6 6 6 6 1 1 1 1 0 1 1 0 0 0 0 0 0 0
0 0 0 0 0 2 6 6 6 6 6 6 6 6 1 1 0 1 1 0 0 0 2 2 2 2
0 0 0 0 0 2 6 6 6 6 6 6 6 6 1 1 0 1 1 0 0 0 0 0 0 0
1 1 1 1 1 1 1 1 6 6 6 6 6 6 6 6 6 6 6 6 6 6 1 1 1 1
1 1 1 1 1 1 1 1 6 6 6 6 6 6 6 6 6 6 6 6 6 6 1 1 1 1
0 0 0 0 0 0 1 1 1 1 6 6 6 6 6 6 6 6 2 0 0 0 0 0 0 0
0 0 0 0 0 0 1 1 1 1 6 6 6 6 6 6 6 6 2 0 0 0 0 0 0 0
0 0 1 1 1 1 1 1 0 0 6 6 6 6 6 6 1 1 1 1 0 0 1 1 0 0
0 0 1 1 1 1 1 1 0 0 6 6 6 6 6 6 1 1 1 1 0 0 1 1 0 0
6 6 6 6 6 6 1 1 6 6 0 0 0 0 0 0 0 0 1 1 0 0 1 1 0 0
6 6 6 6 6 6 1 1 6 6 0 0 0 0 0 0 0 0 1 1 0 0 1 1 0 0
6 6 6 6 6 6 6 6 6 6 2 2 0 0 2 2 0 0 0 0 0 0 1 1 0 0
6 6 6 6 6 6 6 6 6 6 0 0 0 0 0 0 0 0 0 0 1 1 1 1 0 0
1 1 6 6 6 6 6 6 6 6 0 0 0 0 0 0 0 0 1 1 0 0 0 0 0 0
1 1 6 6 6 6 6 6 6 6 0 1 1 1 1 0 0 0 1 1 0 0 0 0 0 0
1 1 1 1 2 0 0 0 0 0 0 1 4 9 1 0 0 0 1 1 0 0 1 1 0 0
1 1 1 1 2 0 0 0 0 0 0 1 9 9 1 0 0 0 1 1 0 0 1 1 0 0